1111111111111
1100100111101
100P0001EC101
1000110000001
1111111111111
